001 001 001 001 001 001 004 001 004 001 004 001 001 001 004 002 001 001 001 001 
001 004 004 004 004 001 004 001 004 001 004 001 004 004 004 002 004 001 004 001 
001 001 004 001 004 001 001 001 001 001 001 001 001 001 002 002 004 001 004 001 
004 001 004 001 004 004 004 004 004 004 004 004 004 004 004 004 004 004 004 001 
001 001 004 001 001 001 001 001 004 001 004 001 001 001 001 001 001 001 004 001
001 004 004 004 004 001 004 004 004 001 004 004 004 004 004 001 004 004 004 001
001 001 004 001 001 001 001 001 001 001 004 001 001 001 004 001 001 001 004 001
004 002 004 004 004 004 004 001 004 004 004 004 004 001 004 001 004 004 004 001
001 001 001 001 001 001 001 001 001 001 001 001 004 001 001 001 004 001 001 001 
001 001 004 004 004 004 004 004 004 004 004 004 004 001 004 001 004 004 004 001 
001 001 004 001 001 001 004 001 001 001 001 001 001 001 004 001 005 001 001 001 
001 004 004 001 004 004 004 004 004 004 004 004 004 005 005 005 005 004 004 001 
001 001 001 001 001 001 001 001 001 001 001 001 001 001 001 001 001 001 001 001 

